NO /Users/zouaraqa/Desktop/imgs/down.png
SO /Users/zouaraqa/Desktop/imgs/up.png
WE /Users/zouaraqa/Desktop/imgs/left.png

EA /Users/zouaraqa/Desktop/imgs/right.png

111
101
111

C    C   1k00   ,   0   , 0

F 150,50,0,,,   l







11111
11E001
  111