NO /Users/zouaraqa/Desktop/imgs/down.png 
SO /Users/zouaraqa/Desktop/imgs/up.png
WE /Users/zouaraqa/Desktop/imgs/left.png
EA /Users/zouaraqa/Desktop/imgs/right.png


F 220,   100    , 1
C 225,30,0




1111111111
1000001
1S01001111
100101111
1111111