NO      /Users/zouaraqa/Desktop/imgs/co in.png 
SO      /Users/zouaraqa/Desktop/imgs/up.png     
WE     /Users/zouaraqa/Desktop/imgs/left.png
EA       /Users/zouaraqa/Desktop/imgs/right.png   


F 220,   100    , 1
C 225,30,0



	1111111111
	100E1
111111111
10101
1111111